$  $$$$$$$
$        $
$  $  $  $
$  $  $  $
$  $$$$$$$
$  $  $  $
$  $  $  $
$     $   
$     $  $
$  $     $
$  $  $  $
$  $  $  $
$  $  $  $
$     $  $
$$$$  $$$$
      $  $
$  $$$$  $
$        $
$  $$$$  $
$$$$$$$  $